

R 1280   720
    NO    texture/1texture.xpm
WE texture/3texture.xpm
EA  texture/4texture.xpm  
S   texture/sprite4.xpm
F 169, 169, 169
C 5, 105, 200
    SO   texture/2texture.xpm 

        1111111111111111111111111
        1000000000110000000000201
        1011000001110000000000001
        1021000000200000000000001
111111111011000001110000200000201
100200000011000001110111110111111     111111
11110111111111011100200010021         100001
11110111111111011101010010001         111111
11000000110101000000000010001
10000000000000001120000010001
10000000200000001101112000001
10000001110101011111111110N0111
11112111 1110121 101111010001
11111111 1111111 111111111111