R  1280 720
S texture/sprite4.xpm
NO texture/texture5.xpm
SO texture/texture6.xpm
WE texture/texture7.xpm
EA texture/texture8.xpm
F 169,169,169
C 105,105,153
        1111111111111111111111111
        1000000000110000222220001
        1011000001110000000000001
        1001000000000222200000001
111111111011000001110000200200001
100000000011000001110111110111111
11110111111111011100000010001
11110111111111011101010010001
11000000110101000000000010001
12222000022222201100200010001
10000000022222201101110000001
12222001110101011111111110N0111
11110111 1110101 101111010001
11111111 1111111 111111111111